実行時刻: 2024-10-10 19:20:20.734801
episode: 19
step: 678

WWWWWWWWWWWWWWWWWWWWWWW
WS↑↑↑↑↑↑↑↑↑↑WPWW↑↑↑W↑PW
W↑WWWWWW↑WWW↑↑W↑↑WWW↑WW
W↑↑↑↑↑↑↑↑↑↑↑↑↑W↑↑↑↑↑↑↑W
W↑WW↑W↑WWWWCWW↑↑WWW↑↑WW
W↑W↑↑WWW↑W↑↑↑↑W↑↑WP↑↑↑W
W↑W↑↑↑↑↑↑WWW↑↑W↑WWWW↑WW
W↑W↑↑W↑W↑↑W↑↑WW↑↑CW↑C↑W
W↑W↑WWWW↑WWWC↑WWW↑WWW↑W
W↑W↑↑W↑W↑W↑↑↑WW↑W↑W↑↑↑W
W↑W↑↑↑↑↑↑↑WW↑↑↑↑↑↑↑↑↑↑W
W↑↑↑W↑W↑W↑↑↑↑↑W↑↑W↑↑W↑W
WWW↑↑↑↑↑WW↑WW↑WWWW↑WW↑W
W↑↑↑W↑W↑↑PWW↑↑WP↑↑↑C↑GW
WWWWWWWWWWWWWWWWWWWWWWW
