実行時刻: 2024-10-10 19:19:00.341757
episode: 10
step: 506

WWWWWWWWWWWWWWWWWWWWWWW
WS↑↑↑↑↑↑↑↑↑↑WPWW↑↑↑W↑PW
W↑WWWWWW↑WWW↑↑W↑↑WWW↑WW
W↑↑↑↑↑↑↑↑↑↑↑↑↑W↑↑↑↑↑↑↑W
W↑WW↑W↑WWWWCWW↑↑WWW↑↑WW
W↑W↑↑WWW↑W↑↑↑↑W↑↑WP↑↑↑W
W↑W↑↑↑↑C↑WWW↑↑W↑WWWW↑WW
W↑W↑↑WPW↑↑W↑↑WW↑↑CW↑C↑W
W↑W↑WWWW↑WWWC↑WWW↑WWW↑W
W↑W↑↑W↑W↑W↑↑↑WW↑W↑W↑↑↑W
W↑W↑↑↑↑↑↑↑WW↑↑↑↑↑↑↑↑↑↑W
W↑↑↑W↑W↑W↑↑↑↑↑W↑↑W↑↑WCW
WWW↑↑↑↑↑WW↑WW↑WWWW↑WW↑W
WP↑↑W↑W↑↑PWW↑↑WP↑↑↑↑↑GW
WWWWWWWWWWWWWWWWWWWWWWW
