実行時刻: 2024-10-10 19:20:03.750653
episode: 17
step: 478

WWWWWWWWWWWWWWWWWWWWWWW
WS↑↑↑↑↑↑↑↑↑PWPWW↑↑↑W↑PW
W↑WWWWWWCWWW↑↑W↑↑WWW↑WW
W↑↑↑↑↑↑↑↑↑↑↑↑↑W↑↑↑↑↑↑↑W
W↑WW↑W↑WWWWCWW↑↑WWW↑↑WW
W↑W↑↑WWW↑W↑↑↑↑W↑↑W↑↑↑↑W
W↑W↑↑↑↑↑↑WWW↑↑W↑WWWW↑WW
W↑W↑↑WPW↑↑W↑↑WW↑↑↑W↑↑↑W
W↑W↑WWWW↑WWWC↑WWW↑WWW↑W
W↑W↑↑W↑W↑W↑↑↑WW↑W↑W↑↑↑W
W↑W↑↑↑↑↑↑↑WW↑↑↑↑↑↑↑↑↑↑W
WC↑↑W↑W↑W↑↑↑↑↑W↑↑W↑↑W↑W
WWW↑↑↑↑↑WW↑WW↑WWWW↑WW↑W
WP↑↑W↑W↑↑PWW↑↑WP↑↑↑C↑GW
WWWWWWWWWWWWWWWWWWWWWWW
