実行時刻: 2024-10-10 19:22:06.411966
episode: 37
step: 300

WWWWWWWWWWWWWWWWWWWWWWW
WS↑↑↑↑↑↑↑↑↑PWPWW↑↑↑W↑PW
W↑WWWWWWCWWW↑↑W↑↑WWW↑WW
W↑↑↑C↑↑↑↑↑↑↑↑↑W↑↑↑↑↑↑↑W
W↑WW↑W↑WWWWCWW↑↑WWW↑↑WW
W↑W↑↑WWW↑W↑↑↑↑W↑↑WP↑↑↑W
W↑W↑↑↑↑↑↑WWW↑↑W↑WWWW↑WW
W↑W↑↑W↑W↑↑W↑↑WW↑↑CW↑C↑W
W↑W↑WWWW↑WWWC↑WWW↑WWW↑W
W↑W↑↑W↑W↑W↑↑↑WW↑W↑W↑↑↑W
W↑W↑↑↑↑↑↑↑WW↑↑↑↑↑↑↑↑↑↑W
W↑↑↑W↑W↑W↑↑↑↑↑W↑↑W↑↑WCW
WWW↑↑↑↑↑WW↑WW↑WWWW↑WW↑W
W↑↑↑W↑W↑↑PWWP↑WP↑↑↑↑↑GW
WWWWWWWWWWWWWWWWWWWWWWW
