実行時刻: 2024-10-10 19:23:47.568240
episode: 63
step: 283

WWWWWWWWWWWWWWWWWWWWWWW
WS↑↑↑↑↑↑↑↑↑↑WPWW↑↑↑W↑PW
W↑WWWWWW↑WWW↑↑W↑↑WWW↑WW
W↑↑↑↑↑↑↑↑↑↑↑↑↑W↑↑↑↑↑↑↑W
W↑WW↑W↑WWWWCWW↑↑WWW↑↑WW
W↑W↑↑WWW↑W↑↑↑↑W↑↑WP↑↑↑W
W↑W↑↑↑↑C↑WWW↑↑W↑WWWW↑WW
W↑W↑↑WPW↑↑W↑↑WW↑↑CW↑C↑W
W↑W↑WWWW↑WWWC↑WWW↑WWW↑W
W↑W↑↑W↑W↑W↑↑↑WW↑W↑W↑↑↑W
W↑W↑↑↑↑↑↑↑WW↑↑↑↑↑↑↑↑↑↑W
W↑↑↑W↑W↑W↑↑↑↑↑W↑↑W↑↑W↑W
WWW↑↑↑↑↑WW↑WW↑WWWW↑WW↑W
W↑↑↑W↑W↑↑PWWP↑WP↑↑↑C↑GW
WWWWWWWWWWWWWWWWWWWWWWW
